407 505 313 266 245 271 294 345 395 412 410 368 336 258 200 180 248 278 301 356 378 369 343 308 281 286 315 462 
441 482 502 539 436 327 248 295 364 397 405 360 322 255 215 211 254 284 338 395 405 376 353 303 275 262 296 607 
345 411 636 707 421 336 267 297 354 407 415 358 306 251 221 211 231 283 352 420 431 419 376 337 266 232 251 328 
374 551 703 440 337 601 264 307 337 369 375 352 327 281 273 268 274 314 346 393 403 398 371 310 270 361 461 555 
337 805 531 463 361 608 258 303 349 348 350 325 298 260 363 501 614 526 435 366 368 342 300 249 245 365 663 775 
247 352 439 551 439 339 236 263 298 314 312 299 303 311 473 876 1045 738 562 393 342 303 263 232 232 531 754 515 
221 240 234 284 261 251 237 250 290 304 306 298 302 330 686 1126 1003 734 806 344 299 274 269 262 265 820 593 510 
215 209 279 330 336 275 239 255 274 276 250 241 259 316 1166 1286 1165 753 1032 459 330 362 392 367 321 406 535 639 
210 250 271 324 343 329 299 299 292 265 195 211 241 308 858 1323 1320 849 771 453 316 453 494 405 379 355 359 355 
215 253 277 318 340 332 336 316 310 263 224 228 241 281 639 953 771 633 799 360 441 501 373 393 514 385 383 341 
206 209 265 326 422 453 499 437 397 308 282 280 242 232 799 579 475 435 759 515 682 529 432 423 533 371 362 322 
173 212 260 296 363 549 624 466 383 272 297 301 256 237 321 421 529 511 608 588 451 457 469 463 426 388 386 425 
154 219 243 250 439 570 419 367 546 283 399 484 548 427 280 191 230 452 592 402 362 562 349 336 304 306 438 469 
177 210 212 229 642 469 343 303 517 324 429 675 732 440 334 218 214 570 421 398 399 592 348 301 273 406 483 276 
163 236 229 289 423 516 563 456 355 286 594 768 524 407 633 256 230 249 315 417 393 331 263 268 253 530 347 249 
159 215 249 318 374 500 556 383 296 244 780 572 527 410 592 215 219 219 207 217 214 219 235 233 209 239 274 275 
208 231 291 321 460 557 415 291 440 279 390 496 613 504 371 223 179 148 165 213 303 419 516 397 277 171 159 156 
237 250 292 289 627 516 456 331 475 274 271 294 312 272 232 203 177 142 141 234 406 754 782 437 283 182 184 149 
243 264 303 330 423 461 466 383 309 241 232 263 274 223 189 149 177 155 182 248 750 940 495 342 589 211 203 127 
284 297 306 327 334 336 309 278 261 244 262 267 268 251 205 165 154 175 202 421 1049 572 429 577 616 259 227 190 
309 296 315 328 321 388 484 563 444 343 296 359 380 386 313 237 132 175 181 580 437 499 542 685 336 272 304 300 
261 282 322 323 340 424 672 721 440 343 263 336 421 458 291 246 197 214 185 264 304 348 298 280 262 307 308 311 
266 303 318 309 311 565 719 465 367 612 311 445 511 382 281 394 209 199 217 199 156 149 173 208 311 321 329 325 
272 280 297 275 274 808 575 486 344 622 303 599 434 378 308 398 200 220 240 216 213 224 251 260 272 286 349 352 
215 236 259 264 285 433 516 550 427 353 281 335 398 435 381 279 243 243 244 258 266 252 266 291 259 258 311 327 
238 265 250 238 257 312 296 258 260 278 295 300 323 320 309 271 268 255 227 253 267 264 287 316 299 298 320 312 
223 228 217 219 244 264 246 242 278 321 336 329 392 365 309 251 245 224 177 234 249 269 303 311 303 338 365 331 
208 189 212 239 280 289 281 250 291 291 303 314 372 371 291 281 270 236 195 251 259 280 291 307 279 314 313 289 
